13 9
TTTTTTTTT
T...+...T
T...~...T
T...R.T.T
T.T.TTT.T
T.x..T*.T
T.*.T...T
T..TTTT.T
T.L..T..T
T...T...T
T.TTTT..T
T..*T...T
TTTTTTTTT