10 30
TTTTTTTTTTTTTTTTTTTTTTTTTTTTTT
T.....T......................T
T.L..#T.........#........#...T
TTTTTRT......................T
T...T.T....#.........#.......T
T...T_TTTTTTTTTT.............T
T....#.........T........#....T
T.........#....T..#..........T
T..............T.............T
TTTTTTTTTTTTTTTTTTTTTTTTTTTTTT