9 9
TTTTTTTTT
TRT...R.T
TTT.TTR.T
TL.R.T..T
TTTR+~T.T
T..R~~R.T
T..TTTR.T
TR~.....T
TTTTTTTTT