11 12
TTTTTTTTTTTT
T.R.~T+~..+T
T.~.TRTT~T.T
Tx.Tx~.RTTRT
T~TTT.T..xTT
T..RT.RTT..T
TTT.TT...T.T
T~...TTTTRTT
TT...RL.T~xT
TR.xT..~.R.T
TTTTTTTTTTTT