7 8
TTTTTTTT
TLTR.x~T
T...R.RT
TRR.R.TT
T.R.T~~T
TxT..R+T
TTTTTTTT