9 9
TTTTTTTTT
T.T.T.T+T
TT.R.RTTT
T.R.T.RRT
TT.R...~T
T.R.T.TxT
TR.TRT.RT
TLR.*RR.T
TTTTTTTTT