8 15
TTTTTTTTTTTTTTT
TxTTR~~xxR~TT+T
T~RTRR~RTRT*RRT
TRTT~TT.TR~xT~T
T~~xRTTTxTR.R~T
TRR~xTR~TtTT~RT
TLR~T~RxR~TTR*T
TTTTTTTTTTTTTTT