9 9
~TTTT~TT~
T+*TT..xT
TR.R.RT.T
TT~.RTR~~
T~RRL~RRT
TxT.~xTT~
TTTTTTT.T
~TxxR~T+T
TT~TTTTTT