19 9
TTTTTTTTT
T...+...T
T...~...T
T...R.T.T
T.T..TT.T
T.x...*.T
T.......T
T..!!...T
TTTRRTTTT
TTTTTTTTT
TTTTTTTTT
TTTTTTTTT
TTTTTTTTT
TTTTTTTTT
TTTTTTTTT
TTTTTTTTT
TTTTTTTTT
TTTL*TTTT
TTTTTTTTT