11 14
TTTTTTTTTTTTTT
T.T.........RR
T.T..TTTTT.^+R
TRTTIxTTT...RR
TTTT]R~TT..R]T
T{[TTATTTT.TTT
TT^TTTTTTA.~xT
T......(TTTTTT
T.RTT.TTTTTTxT
TL.T{[~xRT(~xT
TTTTTTTTTTTTTT