11 14
TTTTTTTTTTTTTT
T.T.........RR
T....TTTTT.^+R
TRTTIxTTT...RR
T.TT]R~TT..R]T
T{[TTATTTT.TTT
TT^TTTTTTA.~xT
T......(TTTTTT
T.RTT.TTTTTTxT
TL.T{[~xRT(~xT
TTTTTTTTTTTTTT