20 20
LR~.~R~R~.~.~R~.~.~.
R~R~.~.~R~R~.~.~R~.~
~R~.~R~.~.~.~R~R~.~.
.~.~.~R~.~.~.~.~R~.~
~R~.~R~.~R~.~R~.~.~.
.~.~R~R~R~R~.~R~R~.~
~R~R~R~.~.~.~R~R~R~.
.~.~R~.~.~R~.~.~R~R~
~.~.~R~R~.~.~R~R~.~.
.~R~.~R~.~R~.~.~.~R~
~.~R~.~R~R~.~R~.~R~.
R~.~R~R~.~.~.~.~.~R~
~.~.~R~.~R~.~R~R~R~.
R~.~R~R~R~.~.~.~R~R~
~R~.~R~.~.~R~.~.~.~.
.~R~R~.~R~R~R~R~.~R~
~.~.~R~.~R~R~.~R~.~.
.~R~R~R~.~R~.~R~.~R~
~.~.~.~.~R~.~.~R~R~.
.~R~.~.~R~.~.~.~.~.+