7 8
TTTTTTTT
T~LR..~T
T~R~~..T
T..~+~.T
T..~~~.T
T.~R...T
TTTTTTTT