30 30
TTTTTTTTTTTTTTTTTTTTTTTTTTTTTL
T............................T
T............................T
T............................T
T............................T
T............................T
T............................T
T............................T
T............................T
T............................T
T............................T
T............................T
T............................T
T............................T
T............................T
T............................T
T............................T
T............................T
T............................T
T............................T
T............................T
T............................T
T............................T
T............................T
T............................T
T............................T
T............................T
+++++++......................T
+++++++......................T
+++++++TTTTTTTTTTTTTTTTTTTTTTT