9 11
TTTTTTTTTTT
T.T.~.....T
T.~RT.T.T.T
T~R.T...R.T
TRT.T.T~T.T
T~.TT~R.T.T
TTRRT.TRT.T
T+~TT.R~TLT
TTTTTTTTTTT